XXXXXXXXXX
XS.X.....X
X.....X..X
X...G.X.EX
XXXXXXXXXX